1 10 8
##########
#.      .#
#  O  O  #
#   1   C#
#        #
#  O  O  #
#.      .#
##########
2 8 5
########
# 1    #
#  O   #
#     .#
########
