1 10 8
##########
#.      .#
#  O  O  #
#   1   C#
#        #
#  O  O  #
#.      .#
##########
2 5 5
#####
#1O #
# O #
#  .#
#####
3 9 7
#########
#1      #
# O     #
# # # # #
#   #.# #
#      C#
#########